cipher
00,00,00,00,00,00,00,00,00,00
00,07,08,06,01,02,03,04,08,00
00,11,12,13,14,15,05,05,05,00
00,16,17,18,19,20,05,05,05,00
00,21,22,23,24,25,05,05,05,00
00,26,27,28,29,30,05,05,05,00
00,00,00,00,05,05,00,00,00,00
00,00,00,00,05,05,00,00,00,00