club_exterior
37,37,37,37,01,02,07,08,03,04,07,08,05,06
36,36,36,36,09,10,15,16,11,12,15,16,13,14
36,36,36,36,17,18,23,24,19,20,23,24,21,22
36,36,36,36,25,26,31,32,27,28,31,32,29,30
36,36,36,36,33,33,33,33,33,33,33,33,33,33
36,36,36,36,33,33,33,33,33,33,33,33,33,33
36,36,36,36,36,36,36,36,36,36,36,36,36,36
36,36,36,36,36,36,36,36,36,36,36,36,36,36