club_interior
00,00,00,00,00,00,00,00,00,00
00,00,07,07,07,07,07,07,00,00
00,00,07,07,07,07,07,07,00,00
00,00,07,07,07,07,07,07,00,00
00,00,07,07,07,07,07,07,00,00
00,00,07,07,07,07,07,07,00,00
00,00,07,07,07,07,07,07,00,00
00,00,15,15,07,07,15,15,00,00